-------------------------------------------------
-------------------------------------------------
-------------------------------------------------
-------------------------------------------------
-------++++++++++++------------------------------
--------+++++++++++------------------------------
-------+++++++++++-------------------------------
----------+++++-----------------+++++++----------
-----------+++++---------------+++++++-----------
------------+++++----------------+++++++---------
-------------+++----------------++++++-----------
---------------------------------+++++++---------
-------------------------------------------------
-------------------------------------------------
--------------------+++++++----------------------
-------------------++++++++----------------------
--------------------+++++++----------------------
-------------------++++++++----------------------
---------------------++++++++--------------------
-----------------------+++++---------------------
-------------------------------------------------
-------------------------------------------------
-------------------------------------------------
-------------------------------------------------
------------------+++++++++++++------------------
---------------------++++++++++++----------------
-------------------++++++----+++++---------------
----------------------++++++++++-----------------
------------------------++++++++-----------------
--------------------------+++++++----------------
---------------------------+++++++---------------
-------------------------------------------------
-------------------------------------------------
-------------------------------------------------
