-------------------------------------------------
-------------------------------------------------
-------------------------------------------------
-------------------------------------------------
-------++++++++++++------------------------------
--------+++++++++++------------------------------
----++++++++++++++-------------------------------
----+-----+++++-----------------+++++++----------
----+--+---+++++---------------+++++++-----------
----+-------+++++----------------++++++++++------
-----+++++++++++----------------++++++--+--------
----------+----------------------+++++++++-------
--------------------------------------+----------
-------------------------++++++-------+----------
-------+------------+++++++---+-------+----------
------+-+----------++++++++---+------------------
-------++-----------+++++++--++++----------------
-------------------++++++++---+------------------
---------------------++++++++++------------------
-----------------------+++++---------------------
--------+----------------------------------------
-------------------------------------------------
-------------------------------------------------
-------------------------------------------------
----++------------+++++++++++++------------------
---------------------++++++++++++----------------
-------------------++++++----+++++---------------
----------------------++++++++++-----------------
------------------------++++++++-----------------
--------------------------+++++++----------------
---------------------------+++++++---------------
-----+-------------------------------------------
-------------------------------------------------
-------------------------------------------------
